00000000000000000000
00000000000000000000
00000000000000000000
10000000000000000001
11000000000000000111
11100000000000111111
11111111111111111111
